М : Space
> : и
О : е
Е : с
1 : о
r : т
Х : н
4 : а
Д : р
a : в
с : д
2 : п
З : к
У : л
\n : ы
Ф : м
Л : я
П : ж
7 : й
А : ь
Р : з
t : у
5 : б
Й : х
b : г
К : ю
< : ч
Б : э
Ь : щ
Ы : ш
Ч : Ц